$........
########.
.......#.
.#####.#.
.#..@#.#.
.#.###.#.
.#.....#.
.#######.
.........